 ################# ####### #############
#.................#.......#.............#
#.#####.###########.###.###.#.#########.#
#...#...#.........#.#.#.....#...#.....#.#
#.#.#####.#######.#.#.#########.###.#.#.#
#.#...#...#...#...#.#.........#...#.#...#
 ####.#.###.###.#.#.#.###.#### ##.#.####
#.....#.#...#...#.#...#...#...#...#.#...#
#.###.#.#.#.#.#######.#####.#.#.###.#.#.#
#...#.#.#.#.#.........#.....#...#.#.#.#.#
#.#.###.###.###########.#########.#.#.#.#
#.#...#.....#.....#...#...#.....#...#.#.#
#.###.#####.#.###.#.#.###.#.#.###.#####.#
#...#.....#.#.#.....#.....#.#...#.......#
 ##.#####.#.#.#.#####.#### ####.#######.#
#...#...#...#.#.#...#.#...#.....#.......#
#.###.#.#####.###.#.###.#.#.#####.######
#.#...#...#.#.....#.#...#.#.......#.....#
#.###.###.#.#######.#.###.#####.###.####
#...#...#.#.....#...#.#.#.....#...#.....#
 ##.###.#.#####.#.###.#.#####.###.#.###.#
#...#...#.......#...#S#.......#.#.#...#.#
#.###.#########.###.###.#######.#.#####.#
#.....#...#.....#.#...#.....#.....#...#.#
 ######.#.#.#####.###.#####.#.#####.#.#.#
#.#.....#.#.......#.#.....#.#.......#...#
#.#.###.## ######.#.#.###.#.######## ##.#
#...#.#...#.....#.#.#.#...#.#.......#...#
#.###.###.#.#.###.#.#.###.#.###.###.#.##
#.#.....#...#.#...#.#...#.#...#...#.#...#
#.#.#########.#.###.###.## ##.#.#.#####.#
#.#.#.........#.....#.#...#...#.#.......#
#.#.#.#######.#####.#.###.#.###.########
#.#.#...#.........#.#...#.#...#.#.......#
#.#.###.#.#######.#.#.###.###.#.###.###.#
#...#...#.#...#...#.#.#...#...#...#.#...#
 ##.#.## ##.#.#####.#.#.###.#####.#.#.##
#...#...#...#.......#.#...#.#...#.#.#...#
#.#####.#.###########.###.#.#.###.#.###.#
#.....#.................#...#.......#O..#
 ##### ################# ### ####### ###
